0,0,0,0,0,0,0,0,0,0,0,0,0,0,0,0,0,0,0,0
0,0,0,0,0,0,0,0,0,0,2,1,1,2,0,0,0,0,0,0
0,0,0,0,0,0,0,0,0,0,1,0,0,1,0,0,2,1,1,2
0,0,1,0,0,0,0,0,0,0,1,0,0,1,0,0,1,0,0,0
5,1,1,1,1,1,1,1,1,1,2,0,0,2,1,1,2,0,0,0
0,0,1,0,0,0,0,0,0,0,1,0,0,1,0,0,1,0,0,0
0,0,0,0,0,0,0,0,0,0,1,0,0,1,0,0,2,1,1,2
0,0,0,0,0,0,0,0,0,0,2,1,1,2,0,0,0,0,0,0
0,0,0,0,0,0,0,0,0,0,0,0,0,0,0,0,0,0,0,0
routes
19,6,LDLULDL
19,2,LULDLUL